탑승자 종류,총원,구조율,사망율,구조인원,사망인원
"1등실, 어린이",6,83%,17%,5,1
"2등실, 어린이",24,100%,0%,24,0
"3등실, 어린이",79,34%,66%,27,52
"1등실, 여성",144,97%,3%,140,4
"2등실, 여성",93,86%,14%,80,13
"3등실, 여성",165,46%,54%,76,89
"1등실, 남성",175,33%,67%,57,118
"2등실, 남성",168,8%,92%,14,154
"3등실, 남성",462,16%,84%,75,387
"승무원, 여성",23,87%,13%,20,3
"승무원, 남성",885,22%,78%,192,693
전체 총합,2224,32%,68%,710,1514
